border_size=1
usage=map

Gll^Fdf, Gll^Fdf, Gll^Fdf, Gll^Fdf, Re, Gll^Fdf, Gll^Fdf, Gll^Fdf, Gll^Fdf, Gll^Fdf, Gll^Fdf, Gll^Fdf, Gll^Fdf, Gll^Fdf, Gll^Fdf, Gll^Fdf, Gll^Fdf, Gll^Fdf, Gll^Fdf, Gll^Fdf, Gll^Fdf, Gll^Fdf, Gll^Fdf, Gll^Fdf, Gll^Fdf, Gll^Fdf, Gll^Fdf, Gll^Fdf, Gll^Fdf, Gll^Fdf, Gll^Fdf, Gll^Fdf, Gll^Fdf, Gll^Fdf, Gll^Fdf, Gll^Fdf, Gll^Fdf, Gll^Fdf, Gll^Fdf, Gll^Fdf, Gll^Fdf, Gll^Fdf, Gll^Fdf, Gll^Fdf, Gll^Fdf, Gll^Fdf
Gll^Fdf, Gll^Fdf, Gll^Fdf, Gs^Fds, Re, Gs^Fds, Gg, Gll^Fdf, Gll^Fdf, Gll^Fdf, Gll^Fdf, Gs^Fds, Gs^Fms, Gs^Fds, Gs^Fms, Gs^Fds, Gll^Fdf, Gs^Fds, Gll^Fdf, Gll^Fdf, Gll^Fmf, Gll^Fmf, Gll^Fmf, Gs^Fds, Gll^Fdf, Gs^Fds, Gll^Fdf, Gs^Fds, Gs^Fms, Gs^Fds, Gs^Fds, Gll^Fmf, Gll^Fmf, Gs^Fds, Gll^Fmf, Gs^Fms, Gll^Fdf, Gll^Fdf, Gll^Fdf, Gll^Fdf, Gll^Fdf, Gll^Fdf, Gll^Fmf, Gll^Fmf, Gll^Fdf, Gll^Fdf
Gll^Fdf, Gs^Fds, Gll^Fdf, Gll^Fdf, Re, Gg, Gg, Gll^Fdf, Gs^Fds, Gll^Fdf, Gll^Fdf, Gll^Fdf, Gll^Fdf, Gs^Fms, Gll^Fdf, Gs^Fds, Gll^Fdf, Gll^Fdf, Gll^Fdf, Gll^Fmf, Gll^Fmf, Gs^Fms, Gll^Fdf, Gll^Fdf, Gll^Fdf, Gll^Fdf, Gll^Fdf, Gll^Fdf, Gs^Fms, Gll^Fdf, Gll^Fmf, Gll^Fdf, Gll^Fdf, Gll^Fdf, Gll^Fmf, Gll^Fmf, Gs^Fds, Gll^Fmf, Gll^Fmf, Gll^Fdf, Gll^Fmf, Gll^Fmf, Gll^Fdf, Gll^Fdf, Gll^Fdf, Gll^Fdf
Gll^Fdf, Gll^Fdf, Gll^Fdf, Gs^Fds, Gll^Fmf, Gll^Fmf, Gll^Fmf, Gll^Fmf, Gll^Fmf, Gs^Fds, Gll^Fdf, Gll^Fdf, Gll^Fmf, Gll^Fdf, Gs^Fds, Gll^Fdf, Gs^Fds, Gll^Fdf, Gs^Fms, Gll^Fdf, Gll^Fmf, Gll^Fmf, Gll^Fmf, Gll^Fdf, Gll^Fmf, Gll^Fmf, Gll^Fdf, Gs^Fms, Gll^Fmf, Gll^Fmf, Gs^Fms, Gs^Fms, Gll^Fdf, Gll^Fdf, Gll^Fdf, Gll^Fmf, Gll^Fmf, Gll^Fmf, Gs^Fds, Gs^Fms, Gll^Fdf, Gll^Fdf, Gll^Fdf, Gll^Fmf, Gll^Fdf, Gll^Fdf
Gll^Fdf, Gll^Fdf, Gll^Fdf, Gll^Fdf, Gll^Fdf, Re, Gll^Fmf, Gg, Gll^Fdf, Gll^Fdf, Gll^Fdf, Gs^Fms, Gll^Fmf, Gll^Fdf, Gs^Fms, Gll^Fdf, Gll^Fdf, Gll^Fdf, Gll^Fdf, Gll^Fmf, Gll^Fdf, Gll^Fmf, Gs^Fms, Gll^Fdf, Gll^Fdf, Gll^Fdf, Gll^Fdf, Gll^Fdf, Gll^Fmf, Gs^Fms, Gll^Fdf, Gll^Fdf, Gll^Fdf, Gll^Fdf, Gll^Fdf, Gs^Fds, Gll^Fmf, Gs^Fds, Gll^Fmf, Gll^Fdf, Gll^Fmf, Gll^Fmf, Gs^Fds, Gll^Fmf, Gll^Fdf, Gll^Fdf
Gll^Fdf, Gll^Fdf, Gll^Fdf, Gs^Fds, Gll^Fdf, Re, Re, Gs^Fds, Gll^Fdf, Gll^Fdf, Gll^Fmf, Gll^Fdf, Gll^Fmf, Gll^Fmf, Gll^Fdf, Gll^Fdf, Gll^Fdf, Gll^Fdf, Gll^Fdf, Gll^Fdf, Gll^Fdf, Gs^Fds, Gll^Fdf, Gll^Fdf, Gll^Fmf, Gll^Fdf, Gll^Fdf, Gll^Fmf, Gll^Fdf, Gll^Fdf, Gll^Fdf, Gll^Fdf, Gll^Fmf, Gll^Fmf, Gll^Fdf, Gll^Fdf, Gll^Fdf, Gll^Fdf, Gll^Fdf, Gll^Fmf, Gs^Fds, Gll^Fdf, Gs^Fds, Gs^Fms, Gll^Fdf, Gll^Fdf
Gll^Fdf, Gll^Fdf, Gll^Fdf, Gll^Fdf, Gll^Fdf, Gs^Fds, Gll^Fdf, Re, Gll^Fdf, Gs^Fds, Gs^Fms, Gs^Fds, Gll^Fdf, Gll^Fdf, Gs^Fds, Gll^Fdf, Gll^Fdf, Gs^Fds, Gll^Fdf, Gll^Fdf, Gs^Fds, Gll^Fdf, Gll^Fdf, Gll^Fdf, Gll^Fmf, Gll^Fdf, Gs^Fms, Gll^Fdf, Gs^Fds, Gs^Fds, Gll^Fdf, Gll^Fdf, Gll^Fdf, Gll^Fdf, Gs^Fds, Gs^Fds, Re, Gll^Fdf, Gll^Fdw, Gs^Fds, Re, Gll^Fdf, Gll^Fdf, Gs^Fms, Gll^Fdf, Gll^Fdf
Gll^Fdf, Gll^Fdf, Gll^Fdf, Gll^Fdf, Gll^Fdf, Gs^Fds, Gg, Gll^Fdf, Gs^Fms, Gll^Fdf, Gll^Fmf, Gll^Fmf, Gll^Fmf, Gll^Fmf, Gll^Fdf, Gll^Fmf, Gll^Fdf, Gll^Fmf, Gll^Fmf, Gll^Fmf, Gll^Fmf, Gs^Fds, Gll^Fmf, Gll^Fdf, Gll^Fmf, Gll^Fmf, Gll^Fdf, Gll^Fdf, Gll^Fdf, Gll^Fdf, Gll^Fdf, Gll^Fdf, Gs^Fds, Re, Gll^Fdw, Re, Re^Vct, Re, Re, Gll^Ecf, Re^Vct, Gs^Fds, Gll^Fdf, Gll^Fdf, Gll^Fdf, Gll^Fdf
Gll^Fdf, Gll^Fdf, Gll^Fdf, Gll^Fdf, Gs^Fds, Gll^Fmf, Gll^Fmf, Re, Gs^Fds, Gll^Fdf, Gll^Fdf, Gll^Fdf, Gll^Fdf, Gll^Fdf, Gll^Fmf, Gll^Fdf, Gll^Fdf, Gll^Fdf, Gll^Fmf, Gll^Fdf, Gs^Fms, Gs^Fds, Gll^Fmf, Gll^Fmf, Gll^Fdf, Gll^Fdf, Gll^Fdf, Gll^Fdf, Gll^Fdf, Gll^Fdf, Gll^Fdf, Gs^Fds, Gll^Fdf, Gll^Fdw, Re^Vct, Re^Edt, Ce, Ce, Ce, Re^Edt, Gll^Fdw, Gs^Fds, Gll^Fdf, Gll^Fdf, Gll^Fdf, Gll^Fdf
Gll^Fdf, Gll^Fdf, Gll^Fdf, Gll^Fdf, Gll^Fdf, Gs^Fds, Gg, Re, Gll^Fdf, Gll^Fdf, Gll^Fdf, Gs^Fms, Gll^Fdf, Gll^Fdf, Gll^Fmf, Gll^Fdf, Gll^Fdf, Gll^Fdf, Gll^Fdf, Gll^Fdf, Gll^Fdf, Gll^Fdf, Gll^Fdf, Gs^Fds, Gs^Fms, Gs^Fds, Gs^Fds, Gs^Fds, Gg, Gs^Fds, Gg, Gll^Fdf, Gll^Fdw, Gs^Fds, Gll^Fdw, Re^Ecf, Ce, 2 Ke, Ce, Re, Re^Vct, Gs^Fds, Re, Gll^Fdf, Gll^Fdf, Gll^Fdf
Gll^Fdf, Gll^Fdf, Gll^Fdf, Gll^Fdf, Gll^Fdf, Gll^Fdf, Gll^Fdf, Gll^Fdf, Re, Gll^Fdf, Gll^Fdf, Gll^Fdf, Gs^Fds, Gs^Fms, Gs^Fds, Gll^Fmf, Gll^Fmf, Gll^Fdf, Gs^Fms, Gs^Fds, Gll^Fdf, Gll^Fdf, Gs^Fds, Gs^Fds, Gs^Fds, Gg, Gg, Gg, Gg, Gg, Gg, Gg, Gg, Gs^Fds, Re, Re, Re^Vct, Ce, Re, Re^Edt, Gll^Fdw, Gll^Fdw, Gs^Fds, Gll^Fdf, Gll^Fdf, Gll^Fdf
Gll^Fdf, Gll^Fdf, Gll^Fdf, Gll^Fdf, Gll^Fdf, Gll^Fdf, Gg, Gs^Fds, Gll^Fdf, Gs^Fds, Gll^Fdf, Gs^Fms, Gll^Fdf, Gll^Fdf, Gll^Fdf, Gll^Fdf, Gll^Fdf, Gll^Fdf, Gll^Fmf, Gll^Fdf, Gll^Fdf, Gs^Fds, Gll^Fdf, Gll^Fdf, Gg, Gg, Gg, Gg, Gg, Gg, Gg, Gg, Gg, Gg, Gll^Fdw, Gs^Fds, Gll^Fdw, Re^Edt, Re^Vct, Gll^Fdw, Gll^Fdw, Gll^Fdw, Gs^Fds, Gs^Fms, Gll^Fdf, Gll^Fdf
Gll^Fdf, Gll^Fdf, Gll^Fdf, Gll^Fdf, Gll^Fdf, Gll^Fdf, Gs^Fds, Gs^Fds, Re, Gll^Fdf, Gll^Fdf, Gll^Fmf, Gll^Fmf, Gll^Fmf, Gll^Fdf, Gll^Fdf, Gll^Fdf, Gll^Fmf, Gll^Fdf, Gll^Fdf, Gll^Fdf, Gll^Fdf, Gg, Gg, Gg, Gg, Gll^Fdf, Gg, Gg, Gg, Gg, Gg, Gg, Gs^Fds, Gs^Fds, Gll^Fdw, Gll^Fdw, Gll^Fdw, Gs^Fds, Re, Gs^Fds, Re, Gll^Fdf, Gll^Fdf, Gll^Fdf, Gll^Fdf
Gll^Fdf, Gll^Fdf, Gll^Fdf, Gll^Fdf, Gll^Fdf, Gll^Fdf, Gs^Fds, Gg, Re, Gll^Fmf, Gll^Fmf, Gll^Fmf, Gll^Fdf, Gll^Fdf, Gll^Fdf, Gll^Fdf, Gg, Gll^Fdf, Gg, Gg, Gg, Gg, Gg, Gg, Gg, Gll^Fdf, Ww, Gg, Gll^Fdf, Gg, Gg, Gg, Gg, Gll^Fdf, Gll^Fdf, Gll^Fmf, Gll^Fmf, Gll^Fdw, Gll^Fdf, Gs^Fds, Gll^Fdf, Gll^Fdf, Gs^Fms, Gll^Fdf, Gll^Fdf, Gll^Fdf
Gll^Fdf, Gll^Fdf, Gll^Fdf, Gll^Fdf, Gll^Fdf, Gll^Fdf, Gll^Fdf, Gll^Fdf, Re, Gll^Fdf, Gll^Fdf, Gll^Fdf, Gg, Gll^Fdf, Gg, Gg, Gg, Gg, Gg, Gg, Gg, Gg, Gg, Gg, Gg, Gg, Gg, Gll^Fdf, Gll^Fdf, Gg, Gg, Gg, Gg, Gs^Fds, Gll^Fmf, Gll^Fdf, Gll^Fdf, Gll^Fmf, Gll^Fmf, Gll^Fmf, Gll^Fmf, Gll^Fmf, Gll^Fmf, Gll^Fmf, Gll^Fmf, Gll^Fdf
Gll^Fdf, Gs^Fds, Gll^Fdf, Gll^Fdf, Gll^Fdf, Gll^Fdf, Gll^Fdf, Gll^Fdf, Gg, Gg, Gg, Gg, Gg, Gg, Gg, Gg, Gg, Gg, Gg, Gg, Gg, Gg, Gg, Gg, Gg, Gg, Gll^Fdf, Gg, Gg, Gg, Gg, Gg, Gg, Gs^Fms, Gll^Fdf, Gll^Fdf, Gll^Fdf, Gll^Fdf, Gs^Fms, Gll^Fdf, Gll^Fmf, Gll^Fdf, Gll^Fmf, Gs^Fms, Gll^Fmf, Gll^Fdf
Gg, Gll^Fdf, Gg, Gll^Fdf, Gg, Gs^Fds, Gg, Gg, Gg, Re, Re, Gg, Gg, Gg, Gg, Gg, Gg, Gg, Gg, Gg, Gg, Gg, Gg, Gg, Gg, Gg, Gg, Gg, Gg, Gg, Gg, Gg, Gg, Gg, Gs^Fds, Gll^Fdf, Gll^Fdf, Gll^Fdf, Gll^Fmf, Gll^Fmf, Gll^Fdf, Gll^Fmf, Gll^Fdf, Gll^Fmf, Gll^Fdf, Gll^Fdf
Gg, Gg, Gg, Gg, Gg, Gg, Gg, Gg, Re, Gg, Gg, Gg, Gg^Gvs, Gg^Gvs, Gg, Gg, Gg, Gg, Gg, Gg, Gg, Gg, Gg, Gg, Gg, Gg, Gg, Gg, Gg, Gg, Gg, Gg, Gg, Gg, Gg, Gll^Fdf, Gll^Fdf, Gll^Fmf, Gll^Fdf, Gs^Fds, Gll^Fdf, Gll^Fdf, Gll^Fdf, Gll^Fdf, Gs^Fds, Gll^Fdf
Gg, Gg, Gg, Gg, Gg, Gg, Gg, Gg, Re, Gg, Gg, Re, Gs^Vh, Gg, Ce, Gg, Gll^Fdf, Gg, Gg^Gvs, Gg, Gg, Gg, Gg, Gg, Gg, Gg, Gg, Gg, Gg, Gg, Gg, Gg, Gg, Gg, Gg, Gg, Gg, Gll^Fdf, Gg, Gs^Fds, Gs^Fds, Gll^Fdf, Gs^Fds, Gll^Fdf, Gll^Fdf, Gll^Fdf
Gg, Gg, Gg, Gg, Gg, Gg, Gg, Gg, Gg, Gg, Gll^Fdf, Gg, Ce, Ce, Ce, Gg, Gs^Fms, Gg^Gvs, Gg^Gvs, Gg, Gg, Gg, Gg, Gg, Gg, Gg, Gg, Gg, Gg, Gg, Gg, Gg, Gg, Gg, Gg, Gg, Gg, Gg, Gg, Gg, Gg, Gg, Gg, Gs^Fds, Gg, Gg
Gg, Gg, Gg, Gg, Gg, Gg, Gg, Gg, Gg, Gg, Gg^Gvs, Gg, Ce, 1 Ke, Ce, Gg, Gg^Gvs, Gs^Vh, Gg^Gvs, Gg, Gg, Gg, Gg, Gg, Gg, Gg, Gg, Gg, Gg, Gg, Gg, Gg, Gg, Gg, Gg, Gg, Gg, Gg, Gg, Gg, Gg, Gg, Gg, Gg, Gg, Gg
Gg, Gg, Gg, Gg, Gg, Gg, Gg, Gg, Gg, Gg^Gvs, Gs^Vh, Gs^Fms, Gg, Ce, Ce, Gg, Gs^Vh, Gg^Gvs, Gg, Gg, Gg, Gg, Gg, Gg, Gg, Gg, Gg, Gg, Re, Re, Re, Gg, Re, Re, Re, Re, Re, Re, Re, Re, Re, Re, Re, Re, Re, Gg
Gg, Gg, Gg, Gg, Gg, Gg, Gg, Gg, Gg, Gg^Gvs, Gg^Gvs, Gg, Gg, Gg, Gg^Gvs, Re, Gll^Fdf, Gg^Gvs, Gg, Gg, Gg, Gg, Gg, Gg, Gg, Gg, Re, Re, Gg, Gg, Gg, Re, Gg, Gg, Gg, Gg, Gg, Gg, Gll^Fdf, Gg, Gg, Gg, Gg, Gg, Gg, Re
Ww, Gg, Gg, Gg, Gg, Gg, Gg, Gg, Gg^Gvs, Gg^Gvs, Gs^Fms, Gs^Fms, Gg^Gvs, Gs^Vh, Gg^Gvs, Gs^Fms, Gll^Fdf, Gg, Gg, Gg, Gg, Gg, Gg, Gg, Re, Re, Gg, Gg, Gg, Gg, Gg, Gg, Gg, Gg, Gll^Fdf, Gs^Fds, Gll^Fdf, Gll^Fdf, Gll^Fdf, Gll^Fdf, Gs^Fds, Gg, Gg, Gg, Gg, Gg
Gg, Ww, Ww, Ww, Ww, Gg, Gg, Gg, Gg^Gvs, Gs^Vh, Gg^Gvs, Gg, Gg, Gg^Gvs, Gg, Re, Gg, Gg, Gg, Gg, Re, Re, Re, Re, Gg, Gg, Gll^Fdf, Gll^Fdf, Gll^Fdf, Gg, Gll^Fdf, Gll^Fdf, Gll^Fdf, Gll^Fdf, Gll^Fdf, Gll^Fdf, Gll^Fdf, Gll^Fdf, Gll^Fdf, Gll^Fdf, Gll^Fdf, Gll^Fdf, Gs^Fds, Gg, Gg, Gg
Gg, Gg, Gg, Gg, Gg, Ww, Ww, Gg, Gg, Gg^Gvs, Gg, Gg, Gg, Gg, Gg, Re, Re, Gg, Re, Re, Gg, Gg, Gll^Fdf, Gll^Fdf, Gll^Fdf, Gll^Fdf, Gll^Fdf, Gll^Fmf, Gll^Fdf, Gll^Fdf, Gll^Fmf, Gll^Fdf, Gs^Fds, Gll^Fdf, Gll^Fdf, Gll^Fdf, Gs^Fms, Gs^Fms, Gll^Fdf, Gll^Fdf, Gll^Fdf, Gs^Fds, Gs^Fds, Gg, Gg, Gg
Gg, Gg, Gg, Gg, Gg, Gg, Gg, Ww, Ww, Gg, Gg, Gg, Gg, Gg, Re, Re, Gg, Re, Gg, Gg, Gll^Fdf, Gs^Fds, Gll^Fdf, Gs^Fds, Gs^Fds, Gll^Fdf, Gll^Fdf, Gll^Fdf, Gll^Fmf, Gll^Fmf, Gs^Fms, Gll^Fmf, Gs^Fds, Gll^Fdf, Gs^Fds, Gll^Fdf, Gs^Fds, Gs^Fds, Gll^Fdf, Gll^Fdf, Gll^Fdf, Gs^Fds, Gs^Fds, Gg, Gg, Gg
Gg, Gg, Gg, Gg, Gg, Gg, Gg, Ww, Ww, Gg, Ww, Ss, Wwf, Re, Gg, Gg, Gg, Gg, Gll^Fdf, Gll^Fdf, Gll^Fdf, Gll^Fmf, Gll^Fmf, Gs^Fds, Gs^Fms, Gs^Fms, Gll^Fmf, Gll^Fdf, Gll^Fdf, Gll^Fmf, Gll^Fdf, Gs^Fds, Gll^Fdf, Gll^Fdf, Gll^Fdf, Gs^Fms, Gll^Fdf, Gll^Fdf, Gll^Fmf, Gll^Fmf, Gll^Fdf, Gll^Fdf, Gll^Fdf, Gg, Gs^Fds, Gg
Gg, Gg, Gg, Gg, Gg, Gg, Gg, Gg, Gg, Ww, Wwf, Gg, Wwf, Gg, Gg, Gg, Gs^Fds, Gll^Fdf, Gll^Fdf, Gll^Fdf, Gll^Fdf, Gll^Fdf, Gll^Fmf, Gll^Fmf, Gll^Fmf, Gll^Fdf, Gll^Fmf, Gll^Fdf, Gll^Fdf, Gll^Fdf, Gll^Fmf, Gll^Fdf, Gll^Fdf, Gll^Fdf, Gll^Fdf, Gll^Fdf, Gs^Fms, Gll^Fmf, Gll^Fdf, Gll^Fmf, Gs^Fds, Gll^Fdf, Gs^Fds, Gll^Fdf, Gll^Fdf, Gs^Fds
Gg, Gg, Gg, Gg, Gg, Gg, Gg, Gg, Gg, Ss, Wwf, Gg, Ww, Gg, Gg, Gg, Gs^Fds, Gll^Fdf, Gll^Fmf, Gll^Fdf, Gll^Fdf, Gll^Fdf, Gll^Fmf, Gll^Fmf, Gll^Fdf, Gll^Fdf, Gll^Fdf, Gll^Fmf, Gll^Fmf, Gs^Fms, Gll^Fmf, Gll^Fmf, Gll^Fdf, Gs^Fds, Gll^Fdf, Gll^Fdf, Gll^Fdf, Gll^Fdf, Gll^Fdf, Gll^Fmf, Gll^Fmf, Gll^Fdf, Gll^Fdf, Gll^Fdf, Gs^Fds, Gs^Fds
Gg, Gg, Gg, Gg, Gg, Gg, Gg, Gg, Gg, Gg, Re, Ww, Ww, Gg, Gg, Gg, Gll^Fdf, Gll^Fdf, Gll^Fdf, Gll^Fmf, Gll^Fdf, Gll^Fdf, Gll^Fdf, Gll^Fdf, Gs^Fms, Gll^Fdf, Gll^Fdf, Gll^Fdf, Gs^Fms, Gll^Fmf, Gll^Fmf, Gll^Fmf, Gs^Fds, Gs^Fds, Gll^Fdf, Gll^Fdf, Gll^Fmf, Gll^Fdf, Gll^Fdf, Gll^Fdf, Gll^Fdf, Gll^Fmf, Gll^Fdf, Gll^Fdf, Gll^Fdf, Gll^Fdf
Gg, Gg, Gg, Gg, Gg, Gg, Gg, Gg, Re, Re, Gg, Ww, Ww, Gg, Gg, Gg, Gll^Fdf, Gll^Fdf, Gll^Fdf, Gll^Fmf, Gll^Fdf, Gs^Fms, Gll^Fdf, Gll^Fdf, Gs^Fds, Gll^Fdf, Gs^Fds, Gll^Fdf, Gll^Fmf, Gll^Fmf, Gll^Fdf, Gll^Fmf, Gll^Fdf, Gll^Fdf, Gs^Fms, Gll^Fmf, Gll^Fdf, Gll^Fdf, Gll^Fdf, Gs^Fms, Gll^Fdf, Gll^Fdf, Gs^Fms, Gll^Fdf, Gll^Fdf, Gll^Fdf
Gg, Gg, Gg, Gg, Gg, Gg, Re, Re, Gg, Gg, Gg, Gg, Gg, Ww, Ww, Gg, Gll^Fdf, Gs^Fds, Gll^Fdf, Gll^Fmf, Gll^Fdf, Gll^Fdf, Gll^Fdf, Gll^Fdf, Gll^Fmf, Gll^Fmf, Gll^Fmf, Gll^Fmf, Gll^Fdf, Gll^Fdf, Gs^Fds, Gll^Fdf, Gs^Fds, Gll^Fdf, Gs^Fds, Gll^Fdf, Gll^Fdf, Gs^Fds, Gll^Fdf, Gll^Fdf, Gs^Fms, Gs^Fms, Gll^Fdf, Gs^Fds, Gll^Fdf, Gs^Fms
Gg, Gg, Gg, Gg, Re, Re, Gg, Gg, Gg, Gg, Gg, Gg, Gg, Gg, Ww, Ww, Gll^Fdf, Gll^Fdf, Gll^Fdf, Gll^Fdf, Gll^Fmf, Gs^Fms, Gs^Fds, Gs^Fds, Gll^Fdf, Gll^Fdf, Gs^Fms, Gll^Fdf, Gll^Fdf, Gs^Fms, Gll^Fdf, Gs^Fms, Gll^Fdf, Gll^Fdf, Gll^Fdf, Gll^Fdf, Gll^Fmf, Gll^Fmf, Gll^Fdf, Gll^Fdf, Gll^Fdf, Gll^Fdf, Gs^Fms, Gll^Fdf, Gs^Fds, Gll^Fdf
Gg, Gg, Re, Gg, Re, Gg, Gg, Gg, Gg, Gg, Gg, Gg, Gg, Gg, Gg, Ww, Ww, Gll^Fdf, Gll^Fdf, Gll^Fdf, Gll^Fdf, Gll^Fdf, Gll^Fdf, Gll^Fdf, Gll^Fdf, Gll^Fdf, Gll^Fdf, Gll^Fdf, Gll^Fdf, Gll^Fdf, Gll^Fdf, Gll^Fdf, Gll^Fdf, Gll^Fdf, Gll^Fdf, Gll^Fdf, Gll^Fdf, Gll^Fdf, Gll^Fdf, Gll^Fdf, Gll^Fdf, Gll^Fdf, Gll^Fdf, Gll^Fdf, Gll^Fdf, Gll^Fdf
