border_size=1
usage=map

Hh, Hh, Hh, Hh, Hh, Gll^Fmf, Gll^Fmf, Gll^Fdf, Hh, Hh, Hh, Hh, Hh, Gll^Fdf, Ww, Gll^Fdf, Gll^Fmf, Gll^Fdf, Gll^Fmf, Gll^Fdf, Hh, Gll^Fmf, Hh, Md, Md, Md, Md, Md, Md, Md, Md, Md, Md, Md, Md
Hh, Hh, Hh, Hh, Hh^Fmf, Hh, Gll^Fdf, Hh, Gll^Fmf, Hh^Fmf, Hh, Hh^Fmf, Hh, Hh, Gll^Fmf, Ww, Ww, Gll^Fdf, Gll^Fmf, Gll^Fmf, Gll^Fmf, Hh, Hh^Fmf, Hh, Md, Md, Md, Md, Md, Md, Md, Md, Md, Md, Md
Hh, Hh^Fmf, Hh^Fmf, Hh, Hh, Hh^Fmf, Gll^Fmf, Gll^Fmf, Gll^Fmf, Gll^Fmf, Gll^Fmf, Gll^Fmf, Gll^Fmf, Hh, Gll^Fmf, Gll^Fmf, Gll^Fdf, Ww, Ww, Gll^Fdf, Gll^Fmf, Hh^Fmf, Hh, Hh, Hh, Gll^Fmf, Hh, Hh^Fmf, Hh^Fmf, Md, Gll^Fdf, Md, Md, Md, Md
Hh, Hh, Hh^Fmf, Hh^Fmf, Hh, Gll^Fmf, Ss, 2 Khr, Chr, Ss, Ss, Gll^Fmf, Gll^Fmf, Gll^Fdf, Ss, Ss, Ss, Gll^Fmf, Ww, Gll^Fmf, Gll^Fdf, Gll^Fmf, Gll^Fmf, Gll^Fmf, Gll^Fmf, Hh^Fmf, Hh^Fmf, Hh, Hh, Hh, Hh, Gll^Fmf, Hh, Md, Gll^Fmf
Hh^Fmf, Hh^Fmf, Hh^Fmf, Hh, Gll, Gll, Ss, Chr, Chr, Ss^Vhs, Gll^Fdf, Gll^Fmf, Gll^Fmf, Gll^Fmf, Gll^Fmf, Ss, Gll^Fmf, Gll^Fmf, Gll^Fmf, Ww, Ww, Gll^Fdf, Gll^Fmf, Gll^Fmf, Gll^Fdf, Gll^Fmf, Gll^Fmf, Hh, Hh^Fmf, Hh, Hh^Fmf, Hh, Hh, Hh, Gll^Fdf
Hh, Hh^Fmf, Hh, Gll^Fmf, Gll^Fmf, Gll^Fmf, Gll^Fmf, Gll^Fmf, Gll^Fdf, Gll, Gll, Gll^Fmf, Gll^Fmf, Gll^Fmf, Gll^Fmf, Gll^Fdf, Gll^Fmf, Gll^Fmf, Hh, Gll^Fmf, Gll^Fmf, Ww, Ww, Ww, Ww, Gll^Fmf, Gll^Fmf, Gll^Fdf, Gll^Fdf, Hh^Fmf, Gll^Fdf, Hh^Fmf, Gll, Gll^Fdf, Gll
Hh, Hh, Hh, Gll^Fmf, Gll^Fmf, Gll^Fmf, Ss, Gll^Fmf, Gll^Fmf, Gll^Fdf, Gll^Fmf, Gll, Gll, Chr, Gll^Fmf, Gll^Fmf, Ss, Gll^Fmf, Hh, Hh^Fmf, Hh, Gll^Fmf, Hh, Hh, Hh, Ww, Ww, Gll^Fdf, Gll, Gll, Gll, Gll, Gll^Fdf, Gll, Gll^Fdf
Gll^Fdf, Hh^Fmf, Gll^Fdf, Gll^Fmf, Gll^Fmf, Ss^Vhs, Gll^Fmf, Gll^Fmf, Gll^Fdf, Gll^Fmf, Chr, Gll^Fdf, Gll^Fdf, Gll, Gll^Fdf, Ss, Gll^Fmf, Hh, Hh, Hh^Fmf, Hh^Fmf, Hh^Fmf, Hh^Fmf, Hh^Fmf, Gll^Fdf, Gll^Fdf, Gll^Fdf, Ww, Ww, Gll^Fdf, Gll^Fdf, Gll^Fdf, Gll^Fdf, Gll^Fdf, Gll^Fdf
Gll^Fmf, Gll^Fmf, Gll^Fmf, Gll^Fmf, Gll^Fdf, Gll^Fmf, Gll^Fmf, Gll^Fmf, Hh, Hh, Hh, Gll^Fmf, Gll^Fmf, Gll, Gll, Gll^Fdf, Gll^Fdf, Hh, Hh^Fmf, Hh^Fmf, Hh^Fmf, Hh^Fmf, Gll^Fmf, Gll^Fdf, Chr, Gll^Fdf, Gll, Gll^Fdf, Ww, Gll^Fdf, Gll^Fdf, Gll^Fmf, Gll^Fdf, Gll^Fdf, Ww
Gll^Fdf, Gll^Fdf, Gll^Fmf, Gll^Fmf, Gll^Fmf, Gll^Fdf, Gll^Fmf, Hh, Hh, Hh, Hh, Hh, Hh, Gll^Fdf, Gll^Fdf, Gll^Fdf, Gll^Fmf, Hh, Hh, Hh, Hh^Fmf, Hh, Gll^Fdf, Chr, Gll, Gll, Gll^Fdf, Gll^Fdf, Gll^Fmf, Ww, Ww, Gll^Fmf, Ww, Ww, Gll^Fdf
Gll^Fdf, Gll^Fmf, Gll^Fdf, Gll^Fmf, Gll, Gll^Fdf, Gll^Fmf, Hh, Hh, Hh^Fmf, Hh, Hh^Fmf, Hh^Fmf, Gll^Fdf, Gll^Fdf, Gll, Gll^Fdf, Gll^Fdf, Hh, Hh, Hh^Fmf, Gll^Fdf, Gll^Fmf, Gll^Fmf, Gll^Fdf, Gll^Fdf, Gll^Fmf, Gll^Fmf, Gll^Fdf, Ww, Ww, Ww, Ss, Ss, Gll^Fdf
Gll^Fdf, Gll^Fmf, Gll^Fmf, Gll^Fmf, Gll, Gll^Fdf, Gll^Fmf, Gll^Fdf, Gll^Fdf, Hh, Hh, Hh^Fmf, Hh^Fmf, Hh, Gll^Fmf, Gll, Gll^Fdf, Gll^Fdf, Gll^Fmf, Hh, Gll^Fdf, Gll^Fdf, Gll, Gll, Gll^Fdf, Gll^Fmf, Gll^Fmf, Gll^Fdf, Gll^Fmf, Hh^Fdf, Hh^Fdf, Hh^Fdf, Ss, Ss, Gll^Fdf
Gll^Fdf, Gll^Fdf, Gll^Fdf, Gll, Gll^Fmf, Gll, Gll^Fdf, Gll^Fdf, Gll, Gll^Fdf, Gll^Fdf, Hh^Fmf, Gll^Fmf, Hh, Gll^Fdf, Gll^Fmf, Gll^Fdf, Gll^Fdf, Gll^Fmf, Gll^Fmf, Gll^Fdf, Gll^Fdf, Gll, Gll^Fdf, Gll^Fdf, Gll^Fmf, Gll^Fmf, Hh^Fmf, Ss, Hh^Fmf, Hh^Fmf, Gll^Fdf, Ss, Ss, Gll^Fdf
Gll^Fdf, Gll^Fdf, Gll, Gll^Fmf, Gll^Fdf, Gll, Gll^Fmf, Gll^Fdf, Gll^Fdf, Gll, Gll, Gll^Fdf, Gll^Fdf, Gll^Fmf, Gll^Fmf, Gll^Fdf, Gll, Gll^Fdf, Gll^Fdf, Gll^Fdf, Gll^Fdf, Gll, Gll^Fdf, Gll^Fdf, Gll^Fdf, Gll^Fmf, Gll^Fdf, Hh^Fdf, Hh^Fmf, Ss, Hh^Fmf, Gll^Fmf, Ss, Ss, Ss
Gll^Fdf, Gll^Fdf, Gll^Fmf, Gll^Fmf, Gll^Fdf, Gll, Gll, Gll^Fdf, Gll^Fdf, Gll^Fdf, Gll, Gll^Fdf, Gll^Fdf, Gll^Fmf, Gll^Fmf, Gll^Fdf, Gll^Fdf, Ss, Gll^Fdf, Gll^Fdf, Gll^Fdf, Gll^Fmf, Ss, Gll^Fdf, Gll^Fdf, Gll^Fmf, Gll^Fdf, Hh^Fdf, Hh^Fdf, Ss, Ss, Ss, Ss, Gll^Fmf, Ss
Gll^Fdf, Gll^Fdf, Gll, Gll^Fmf, Gll^Fdf, Gll^Fdf, Gll^Fmf, Gll^Fdf, Gll^Fdf, Gll^Fdf, Gll^Fdf, Gll, Gll, Gll^Fdf, Gll^Fmf, Gll^Fdf, Gll^Fmf, Ss, Gll^Fdf, Gll, Gll^Fmf, Ss, Ss, Ss, Gll^Fdf, Gll^Fmf, Gll^Fmf, Gll^Fmf, Hh^Fdf, Hh^Fdf, Gll^Fdf, Ss, Khr, Ss, Ss
Gll^Fdf, Gll^Fdf, Gll^Fdf, Gll^Fmf, Gll^Fmf, Gll^Fdf, Gll^Fdf, Gll^Fmf, Gll^Fmf, Gll^Fdf, Gll^Fdf, Gll^Fdf, Gll^Fmf, Gll^Fdf, Gll^Fdf, Gll^Fdf, Gll^Fmf, Gll^Fdf, Gll^Fdf, Gll, Gll^Fmf, Gll^Fdf, Gll^Fdf, Gll^Fdf, Gll^Fmf, Gll^Fmf, Gll^Fdf, Hh^Fdf, Hh^Fdf, Gll^Fmf, Ss^Vhs, Chr, Gll^Fdf, Gll^Fmf, Ss
Gll^Fdf, Gll^Fdf, Gll^Fdf, Gll^Fmf, Gll^Fmf, Gll^Fmf, Gll^Fdf, Gll^Fmf, Gll^Fdf, Gll^Fdf, Gll^Fdf, Gll^Fmf, Gll^Fmf, Gll^Fdf, Gll^Fdf, Ss, Gll^Fmf, Gll^Fdf, Gll^Fdf, Gll^Fdf, Gll^Fdf, Gll, Gll, Gll^Fmf, Gll^Fmf, Gll^Fmf, Gll^Fdf, Hh^Fdf, Gll^Fmf, Gll^Fmf, Chs, Chs, Gll^Fdf, Gll^Fmf, Gll^Fdf
Gll^Fdf, Gll^Fdf, Hh, Gll^Fmf, Ss^Vhs, Ss, Khr, Chr, Ss, Gll^Fdf, Gll^Fmf, Gll^Fdf, Gll^Fmf, Gll^Fmf, Gll^Fmf, Gll^Fmf, Gll^Fmf, Gll^Fdf, Gll^Fmf, Gll^Fdf, Gll^Fdf, Gll^Fdf, Gll, Gll^Fmf, Gll^Fdf, Gll^Fmf, Gll^Fdf, Gll^Fmf, Gll, Gll, Gll^Fmf, Gll^Fmf, Gll^Fmf, Ss^Vhs, Gll^Fdf
Gll^Fdf, Gll^Fdf, Hh, Gll^Fdf, Ss, Ss, Chr, Chs, Gll, Ss^Vhs, Gll^Fmf, Gll^Fmf, Gll^Fdf, Gll^Fmf, Gll^Fdf, Gll^Fdf, Gll^Fdf, Gll^Fdf, Gll^Fdf, Gll^Fmf, Gll^Fdf, Gll^Fdf, Gll, Gll^Fdf, Gll^Fdf, Gll^Fdf, Gll^Fdf, Gll^Fmf, Gll, Gll, Gll^Fdf, Gll^Fmf, Gll^Fdf, Gll^Fmf, Gll^Fdf
Gll^Fdf, Gll^Fdf, Hh^Fmf, Hh^Fmf, Gll^Fmf, Gll^Fmf, Gll^Fmf, Gll, Gll, Gll^Fdf, Gll^Fdf, Gll^Fdf, Gll, Gll^Fdf, Gll, Gll, Gll, Gll^Fdf, Gll, Gll, Gll^Fdf, Gll^Fdf, Gll^Fdf, Gll, Gll, Gll^Fdf, Gll, Gll^Fdf, Gll^Fdf, Gll^Fmf, Gll^Fmf, Gll^Fmf, Hh, Hh, Gll^Fdf
Gll^Fdf, Gll^Fdf, Hh, Gll^Fdf, Hh, Gll^Fdf, Ss, Gll, Gll, Gll, Gll, Gll, Gll^Fdf, Gll, Gll^Fdf, Gll^Fdf, Gll^Fdf, Gll^Fdf, Gll^Fdf, Gll^Fdf, Gll^Fmf, Gll^Fdf, Gll^Fmf, Gll^Fdf, Gll^Fmf, Gll^Fmf, Gll^Fdf, Gll^Fdf, Gll^Fdf, Gll^Fdf, Hh, Hh, Hh, Gll, Gll^Fdf
Gll^Fdf, Hh, Hh, Hh, Hh, Gll, Gll^Fdf, Gll^Fdf, Gll^Fdf, Gll^Fdf, Gll, Gll^Fdf, Gll^Fmf, Gll^Fdf, Gll^Fdf, Gll^Fdf, Gll^Fmf, Gll^Fmf, Gll^Fdf, Gll^Fmf, Gll^Fdf, Gll, Gll^Fdf, Gll^Fdf, Gll^Fdf, Gll^Fmf, Gll^Fdf, Gll^Fmf, Gll^Fmf, Gll^Fdf, Hh^Fmf, Hh^Fmf, Hh, Gll^Fmf, Gll^Fmf
Gll^Fdf, Gll^Fdf, Gll^Fdf, Hh, Gll^Fdf, Gll^Fdf, Hh, Gll^Fdf, Gll^Fdf, Gll^Fmf, Gll, Gll, Gll^Fmf, Gll^Fdf, Gll^Fdf, Gll^Fdf, Hh^Fmf, Gll^Fdf, Hh^Fmf, Gll^Fdf, Gll, Gll^Fdf, Gll^Fdf, Gll^Fdf, Gll^Fdf, Gll, Gll^Fdf, Gll^Fdf, Gll^Fmf, Gll, Hh, Hh^Fmf, Hh, Hh, Gll^Fdf
Gll^Fdf, Gll^Fmf, Gll^Fdf, Gll^Fdf, Gll, Gll^Fdf, Hh, Hh, Hh, Hh, Hh, Hh, Gll^Fmf, Gll^Fmf, Hh^Fmf, Hh^Fmf, Hh^Fmf, Gll^Fdf, Gll^Fdf, Hh^Fmf, Gll^Fmf, Gll^Fmf, Gll^Fmf, Gll^Fdf, Gll^Fdf, Gll, Gll^Fdf, Gll^Fmf, Gll^Fmf, Gll, Gll^Fmf, Hh, Hh, Hh, Hh
Gll^Fdf, Gll, Gll^Fmf, Gll^Fdf, Hh^Fmf, Hh, Gll^Fmf, Hh, Hh, Hh, Gll^Fmf, Gll, Gll^Fdf, Gll^Fmf, Gll^Fmf, Gll^Fmf, Gll^Fdf, Gll, Gll^Fdf, Gll^Fdf, Gll^Fmf, Gll^Fmf, Gll^Fmf, Gll^Fmf, Re^Vct, Gll, Gll^Fdf, Gll^Fmf, Gll^Fmf, Gll^Fmf, Gll^Fdf, Hh, Hh, Gll^Fmf, Gll^Fdf
Gll^Fmf, Gll, Gll^Fmf, Gll^Fmf, Hh^Fmf, Hh, Gll^Fmf, Hh^Fmf, Gll^Fmf, Gll^Fmf, Gll^Fmf, Gll, Gll^Fmf, Gll, Gll, Gll^Fdf, Gll^Fdf, Gll, Gll^Fdf, Gll^Fdf, Gll^Fdf, Gll^Fmf, Re^Vct, Gll^Fmf, Gll, Gll, Gll, Gll^Fdf, Gll^Fdf, Gll^Fmf, Gll^Fdf, Gll^Fmf, Gll^Fmf, Gll^Fmf, Gll^Fdf
Gll^Fmf, Gll^Fdf, Gll^Fmf, Gll^Fmf, Hh, Gll^Fmf, Gll^Fdf, Hh^Fmf, Gll^Fmf, Gll^Fdf, Gll^Fdf, Gll, Gll^Fdf, Gll^Fdf, Gll, Gll^Fdf, Gll, Gll^Fdf, Gll, Gll^Fdf, Re^Vct, Gll^Fmf, Gll^Ecf, Gll, Ce, Ce, Ce, Gll, Gll^Fdf, Gll^Fdf, Gll^Fmf, Gll^Fmf, Gll^Fmf, Gll^Fdf, Gll^Fdf
Gll^Fmf, Gll^Fmf, Gll^Fmf, Gll^Fdf, Gll^Fmf, Gll^Fdf, Gll^Fmf, Hh, Hh, Gll^Fmf, Gll^Fmf, Gll^Fmf, Gll, Gll, Gll, Gll, Gll^Fmf, Gll, Gll^Fdf, Gll, Gll^Fdf, Gll, Re^Vct, Gll, Ce, 1 Ke, Ce, Gll, Gll^Fdf, Gll^Fmf, Gll^Fdf, Gll, Gll^Fdf, Gll^Fdf, Gll^Fdf
Gll^Fmf, Gll^Fmf, Gll^Fmf, Gll^Fdf, Gll^Fdf, Gll^Fdf, Gll^Fmf, Gll^Fmf, Gll^Fdf, Gll^Fmf, Gll^Fdf, Gll, Gll, Gll, Gll^Fdf, Gll^Fdf, Gll^Fdf, Gll^Fdf, Gll^Fdf, Gll^Fdf, Gll^Fmf, Gll^Fdf, Gll^Fdf, Gll, Gll, Ce, Gll, Gll, Gll^Fmf, Gll^Fmf, Gll^Fdf, Gll^Fmf, Gll, Gll^Fdf, Gll^Fdf
Gll^Fmf, Gll^Fmf, Gll^Fmf, Gll^Fdf, Gll^Fmf, Gll^Fmf, Gll^Fdf, Gll^Fmf, Gll^Fdf, Gll, Gll, Gll, Gll^Fmf, Gll^Fmf, Gll^Fdf, Gll^Fdf, Gll, Gll^Fmf, Gll^Fmf, Gll^Fdf, Gll^Fmf, Gll^Fdf, Gll^Fdf, Gll^Fdf, Gll^Fdf, Gll, Gll^Fdf, Gll, Gll^Fdf, Gll^Fmf, Gll^Fmf, Gll, Gll^Fmf, Gll^Fdf, Gll^Fdf
Gll^Fmf, Gll^Fdf, Gll^Fmf, Gll^Fmf, Gll^Fmf, Gll^Fmf, Gll^Fmf, Gll^Fdf, Gll, Gll, Gll^Fdf, Gll^Fdf, Gll^Fdf, Gll^Fmf, Gll^Fmf, Gll^Fdf, Hh, Gll^Fmf, Hh, Gll^Fmf, Hh, Gll^Fdf, Gll^Fmf, Gll^Fdf, Gll^Fmf, Gll^Fmf, Gll^Fmf, Gll, Gll, Gll^Fdf, Gll^Fdf, Gll^Fmf, Gll, Gll^Fdf, Gll^Fdf
Gll^Fmf, Gll^Fmf, Gll^Fmf, Gll^Fmf, Gll^Fdf, Gll^Fdf, Gll, Gll, Gll^Fdf, Gll^Fdf, Gll^Fmf, Gll^Fdf, Gll, Gll^Fmf, Gll^Fdf, Gll^Fmf, Gll^Fmf, Hh, Hh, Hh, Hh, Gll^Fmf, Gll^Fmf, Gll^Fdf, Gll^Fdf, Gll^Fdf, Gll^Fdf, Gll^Fmf, Gll, Gll^Fdf, Gll^Fdf, Gll^Fmf, Gll, Gll^Fdf, Gll^Fdf
Gll^Fmf, Gll^Fmf, Gll^Fmf, Gll^Fmf, Gll^Fdf, Gll^Fdf, Gll, Gll^Fdf, Gll^Fdf, Gll^Fmf, Gll, Gll^Fdf, Gll^Fmf, Gll^Fmf, Gll^Fdf, Gll, Gll, Gll, Gll, Hh, Hh, Gll, Gll^Fmf, Gll^Fmf, Gll^Fmf, Gll^Fdf, Gll^Fdf, Gll^Fdf, Gll, Gll, Gll^Fdf, Gll^Fmf, Gll^Fmf, Gll^Fdf, Gll^Fdf
Gll^Fdf, Gll^Fmf, Gll^Fdf, Gll^Fdf, Gll, Gll, Gll^Fmf, Gll^Fmf, Gll^Fdf, Gll, Gll, Gll, Gll^Fdf, Gll^Fdf, Gll^Fdf, Gll^Fdf, Gll^Fdf, Gll, Gll^Fdf, Gll^Fdf, Gll^Fdf, Gll, Gll, Gll^Fmf, Gll^Fdf, Gll^Fdf, Gll^Fdf, Gll^Fdf, Gll, Gll, Gll^Fdf, Gll^Fmf, Gll^Fdf, Gll^Fdf, Gll^Fdf
