border_size=1
usage=map

Gll^Fdf, Gll^Fdf, Gll^Fdf, Gll^Fdf, Gll^Fdf, Gll^Fdf, Gll^Fdf, Gll^Fdf, Gll^Fdf, Gll^Fdf, Gll^Fdf, Gll^Fdf, Gll^Fdf, Gll^Fdf, Gll^Fdf, Gll^Fdf, Gll^Fdf, Gll^Fdf, Hh^Fdf, Gll^Fdf, Hh^Fdf, Gll^Fdf, Hh^Fdf, Gll^Fdf, Hh^Fdf, Gll^Fdf, Hh^Fdf, Gll^Fdf, Hh^Fdf, Gll^Fdf, Hh^Fdf, Gll^Fdf, Hh^Fdf, Gll^Fdf, Hh^Fdf, Gll^Fdf, Hh^Fdf, Gll^Fdf, Hh^Fdf, Gll^Fdf, Mm, Gll^Fdf, Mm, Mm, Mm, Mm
Gll^Fdf, Gll^Fdf, Gll^Fdf, Gll^Fdf, Gll^Fdf, Gll^Fdf, Gll^Fdf, Gll^Fdf, Gll^Fdf, Gll^Fdf, Gll^Fdf, Gll^Fdf, Gll^Fdf, Gll^Fdf, Gll^Fdf, Gll^Fdf, Gll^Fdf, Hh^Fdf, Mm, Hh, Mm, Hh^Fdf, Mm, Hh^Fdf, Hh, Hh^Fdf, Hh^Fdf, Hh^Fdf, Mm, Hh, Mm, Hh^Fdf, Hh^Fdf, Hh^Fdf, Hh^Fdf, Hh^Fdf, Gll^Fdf, Hh^Fdf, Mm, Mm, Mm, Mm, Mm, Mm, Mm, Mm
Gll^Fdf, Gll^Fdf, Gll^Fdf, Gll^Fdf, Gll^Fdf, Gll^Fdf, Gll^Fdf, Gll^Fdf, Gll^Fdf, Gll^Fdf, Gs, Gll^Fdf, Gll^Fdf, Gll^Fdf, Gll^Fdf, Gll^Fdf, Hh^Fdf, Gll^Fdf, Mm, Mm, Mm, Mm, Mm, Mm, Mm, Mm, Mm, Mm, Mm, Mm, Mm, Mm, Mm, Mm, Mm, Mm, Mm, Mm, Mm, Mm, Mm, Mm, Mm, Mm, Mm, Mm
Gll^Fdf, Gll^Fdf, Gll^Fdf, Gs, Gs, Gs, Gs, Gll^Fdf, Gs, Gll^Fdf, Gll^Fdf, Gs, Gs, Gll^Fdf, Gll^Fdf, Gll^Fdf, Hh^Fdf, Hh^Fdf, Hh^Fdf, Mm, Hh, Mm, Mm, Mm, Mm, Mm, Mm, Mm, Mm, Mm, Ms, Mm, Mm, Mm, Mm, Mm, Mm, Mm, Mm, Mm, Mm, Mm, Ms, Ms, Ms, Mm
Ww, Ww, Ww, Ww, Ww, Gll^Fdf, Ww, Gs, Gll^Fdf, Gs, Gs, Gll^Fdf, Gll^Fdf, Gll^Fdf, Gll^Fdf, Gll^Fdf, Gll^Fdf, Gll^Fdf, Gll^Fdf, Hh^Fdf, Hh^Fdf, Hh^Fdf, Hh^Fdf, Hh^Fdf, Hh, Hh, Hh, Mm, Mm, Mm, Mm, Ms, Mm, Ms, Ms, Ms, Ms, Ms, Ms, Mm, Ms, Ms, Ms, Ms, Mm, Mm
Gll^Fdf, Gll^Fdf, Gll^Fdf, Gll^Fdf, Gll^Fdf, Ww, Gll^Fdf, Ww, Ww, Gs, Gs, Gs, Gll^Fdf, Gll^Fdf, Gs, Gll^Fdf, Gll^Fdf, Gll^Fdf, Gs, Gll^Fdf, Gll^Fdf, Hh^Fdf, Hh^Fdf, Hh^Fdf, Hh^Fdf, Hh, Hh, Hh, Mm, Mm, Mm, Mm, Mm, Mm, Mm, Ms, Ms, Ms, Mm, Ms, Mm, Mm, Mm, Mm, Mm, Mm
Gll^Fdf, Gll^Fdf, Gs, Gll^Fdf, Gll^Fdf, Gll^Fdf, Gs, Gll^Fdf, Gll^Fdf, Ww, Ww, Gs, Gs, Gs, Gll^Fdf, Gll^Fdf, Gll^Fdf, Gs, Gll^Fdf, Gll^Fdf, Gll^Fdf, Gll^Fdf, Gll^Fdf, Gll^Fdf, Hh^Fdf, Hh^Fdf, Hh^Fdf, Hh, Mm, Mm, Mm, Mm, Mm, Mm, Mm, Mm, Mm, Mm, Mm, Mm, Mm, Mm, Mm, Mm, Mm, Mm
Gll^Fdf, Gll^Fdf, Gs, Gs, Gs, Gs, Gs, Gll^Fdf, Gll^Fdf, Ww, Ww, Gll^Fdf, Ww, Gll^Fdf, Gll^Fdf, Gll^Fdf, Gll^Fdf, Gs, Gs, Gll^Fdf, Gll^Fdf, Gs, Gll^Fdf, Hh^Fdf, Hh, Hh, Hh, Hh^Fdf, Hh^Fdf, Mm, Gll^Fdf, Mm, Hh^Fdf, Mm, Mm, Mm, Mm, Mm, Mm, Mm, Mm, Mm, Mm, Mm, Mm, Gll^Fdf
Gll^Fdf, Gs, Gll^Fdf, Gs, Gll^Fdf, Gs, Gll^Fdf, Gs, Gll^Fdf, Ww, Ww, Ww, Ww, Ww, Ww, Ww, Ww, Gll^Fdf, Gll^Fdf, Gs, Gs, Gs, Gs, Hh^Fdf, Hh^Fdf, Hh^Fdf, Hh^Fdf, Hh, Hh, Hh^Fdf, Hh^Fdf, Hh^Fdf, Hh, Hh, Hh^Fdf, Hh^Fdf, Hh^Fdf, Mm, Mm, Mm, Mm, Mm, Mm, Mm, Mm, Gll^Fdf
Gs, Gs, Gs, Gs, Gs, Gs, Gs, Gs, Gll^Fdf, Ww, Ww, Gll^Fdf, Wo, Wo, Ww, Ww, Wo, Ww, Ww, Gs, Gll^Fdf, Gs, Gs, Gll^Fdf, Gll^Fdf, Hh^Fdf, Gll^Fdf, Hh^Fdf, Hh^Fdf, Hh, Hh^Fdf, Hh, Hh^Fdf, Hh, Hh^Fdf, Hh^Fdf, Hh, Hh^Fdf, Hh^Fdf, Hh^Fdf, Hh, Hh, Hh, Hh, Hh^Fdf, Gll^Fdf
Gll^Fdf, Gs, Gs, Gs, Gs, Gs, Gs, Gs, Gll^Fdf, Ww, Ww, Ww, Wo, Ww, Gll^Fdf, Gll^Fdf, Gll^Fdf, Wo, Wo, Ww, Ww, Gll^Fdf, Gll^Fdf, Gll^Fdf, Gll^Fdf, Gll^Fdf, Gll^Fdf, Gll^Fdf, Gll^Fdf, Hh^Fdf, Hh^Fdf, Hh^Fdf, Gll^Fdf, Hh^Fdf, Hh, Hh^Fdf, Hh, Hh^Fdf, Hh, Hh, Hh, Hh, Hh, Hh, Hh, Hh^Fdf
Gll^Fdf, Gll^Fdf, Gs, Gll^Fdf, Gs, Gs, Gs, Gll^Fdf, Gs, Ww, Ww, Wo, Gs, Gs, Gs, Gg^Fet, Gs, Gg^Ve, Gll^Fdf, Ww, Ww, Ww, Gll^Fdf, Gll^Fdf, Gg^Ve, Gll^Fdf, Gll^Fdf, Gll^Fdf, Gll^Fdf, Gll^Fdf, Gll^Fdf, Gll^Fdf, Gll^Fdf, Gll^Fdf, Gll^Fdf, Hh^Fdf, Gll^Fdf, Hh, Hh, Hh, Hh, Hh^Fdf, Hh, Hh, Hh, Hh^Fdf
Gll^Fdf, Gll^Fdf, Gll^Fdf, Gs, Gll^Fdf, Gll^Fdf, Gs, Gll^Fdf, Gs, Ww, Ww, Gll^Fdf, Gs, Gs, Cv, Gs, Cv, Gs, Gs, Gll^Fdf, Ww, Ww, Gll^Fdf, Gll^Fdf, Gll^Fdf, Gll^Fdf, Gll^Fdf, Gll^Fdf, Gs, Gs, Gll^Fdf, Gs, Gll^Fdf, Gs, Gll^Fdf, Gll^Fdf, Gll^Fdf, Gll^Fdf, Gll^Fdf, Hh, Gll^Fdf, Hh, Gll^Fdf, Hh, Gll^Fdf, Gll^Fdf
Gll^Fdf, Gll^Fdf, Gs, Gs, Gll^Fdf, Gll^Fdf, Gll^Fdf, Gll^Fdf, Gs, Ww, Ww, Gg^Fet, Gs, Gg^Ve, Cv, Kv, Cv, Gg^Ve, Gs, Gg^Fet, Ww, Ww, Gll^Fdf, Gll^Fdf, Gll^Fdf, Gll^Fdf, Gs, Gs, Gll^Fdf, Gll^Fdf, Gll^Fdf, Gll^Fdf, Gll^Fdf, Gll^Fdf, Gll^Fdf, Gll^Fdf, Gll^Fdf, Gll^Fdf, Gll^Fdf, Gs, Gll^Fdf, Gll^Fdf, Gll^Fdf, Gll^Fdf, Gll^Fdf, Gll^Fdf
Gll^Fdf, Gll^Fdf, Gll^Fdf, Gll^Fdf, Gs, Gll^Fdf, Gll^Fdf, Gs, Gs, Ww, Ww, Gll^Fdf, Gg^Ve, Gs, Gs, Gs, Gs, Gs, Gll^Fdf, Gll^Fdf, Ww, Ww, Gll^Fdf, Gll^Fdf, Gs, Gll^Fdf, Gll^Fdf, Gll^Fdf, Gg^Ve, Gll^Fdf, Gll^Fdf, Gll^Fdf, Gll^Fdf, Gll^Fdf, Gll^Fdf, Gs, Gll^Fdf, Gll^Fdf, Gll^Fdf, Gll^Fdf, Gll^Fdf, Gll^Fdf, Gll^Fdf, Gll^Fdf, Gll^Fdf, Gll^Fdf
Gll^Fdf, Gll^Fdf, Gs, Gll^Fdf, Gs, Gll^Fdf, Gs, Gll^Fdf, Gll^Fdf, Ww, Ww, Wo, Wo, Gll^Fdf, Gs, Gg^Fet, Gll^Fdf, Gs, Ww, Ww, Ww, Ww, Gs, Gll^Fdf, Gll^Fdf, Gs, Gll^Fdf, Gs, Gll^Fdf, Gs, Gll^Fdf, Gs, Gs, Gll^Fdf, Gll^Fdf, Gll^Fdf, Gll^Fdf, Gll^Fdf, Gll^Fdf, Gll^Fdf, Gll^Fdf, Gll^Fdf, Gll^Fdf, Gll^Fdf, Gll^Fdf, Gll^Fdf
Gll^Fdf, Gll^Fdf, Gll^Fdf, Gs, Gs, Gll^Fdf, Gll^Fdf, Gll^Fdf, Gll^Fdf, Gll^Fdf, Ww, Ww, Wo, Gll^Fdf, Kv, Gll^Fdf, Kv, Gs, Ww, Ww, Ww, Ww, Ww, Gs, Gs, Gll^Fdf, Gll^Fdf, Gll^Fdf, Gll^Fdf, Gll^Fdf, Gll^Fdf, Gll^Fdf, Gll^Fdf, Gll^Fdf, Gll^Fdf, Gll^Fdf, Gs, Gll^Fdf, Gll^Fdf, Gll^Fdf, Gs, Gs, Gs, Gll^Fdf, Gll^Fdf, Gll^Fdf
Gll^Fdf, Gll^Fdf, Gll^Fdf, Gs, Gs, Gll^Fdf, Gll^Fdf, Gll^Fdf, Gs, Gll^Fdf, Gs, Ww, Ww, Ww, Ww, Ww^Bsb|, Ww, Ww, Ww, Gll^Fdf, Gll^Fdf, Wo, Wo, Wo, Ww, Gs, Gs, Gs, Gll^Fdf, Gll^Fdf, Ce, Ce, Ce, Gll^Fdf, Gs, Gs, Gll^Fdf, Gs, Gs, Gs, Gll^Fdf, Gll^Fdf, Gll^Fdf, Gs, Gs, Gll^Fdf
Gll^Fdf, Gll^Fdf, Gll^Fdf, Gll^Fdf, Gs, Gs, Gll^Fdf, Gll^Fdf, Gll^Fdf, Gll^Fdf, Gll^Fdf, Gs, Gll^Fdf, Ww, Ww, Ww^Bsb|, Ww, Ww, Ww, Gg^Ve, Ww, Ww, Ww, Ww, Ww, Ww, Ww, Gs, Gs, Gs, Ce, Ke, Ce, Gll^Fdf, Gll^Fdf, Gll^Fdf, Gll^Fdf, Gs, Gll^Fdf, Gll^Fdf, Gs, Gll^Fdf, Gll^Fdf, Gll^Fdf, Gs, Gll^Fdf
Gll^Fdf, Gll^Fdf, Gs, Gll^Fdf, Gs, Gll^Fdf, Gs, Gs, Gs, Gll^Fdf, Gll^Fdf, Gll^Fdf, Gll^Fdf, Gll^Fdf, Gll, Ww^Bsb|, Gll, Gll^Fdf, Gll^Fdf, Ww, Gll^Fdf, Gll^Fdf, Gll^Fdf, Ww, Gll^Fdf, Ww, Ww, Ww, Ww, Gs, Gs, Ce, Gs, Gll^Fdf, Gll^Fdf, Gll^Fdf, Gll^Fdf, Gll^Fdf, Gll^Fdf, Gll^Fdf, Gll^Fdf, Gll^Fdf, Gll^Fdf, Gll^Fdf, Gs, Gll^Fdf
Gll^Fdf, Gs, Hh^Fdf, Gll^Fdf, Hh, Gll^Fdf, Hh^Fdf, Gll^Fdf, Hh, Gll^Fdf, Hh^Fdf, Gs, Gll^Fdf, Gll^Fdf, Gll^Fdf, Gll, Gll^Fdf, Gll^Fdf, Gll^Fdf, Gll^Fdf, Gll^Fdf, Gll^Fdf, Gll^Fdf, Gll^Fdf, Kv, Gll^Fdf, Gll^Fdf, Ww, Ww, Ww, Ww, Gs, Gs, Gs, Gs, Gll^Fdf, Gs, Gll^Fdf, Gll^Fdf, Gll^Fdf, Gll^Fdf, Gs, Gs, Gll^Fdf, Gll^Fdf, Gll^Fdf
Gll^Fdf, Gll^Fdf, Gll^Fdf, Hh, Gll^Fdf, Hh^Fdf, Mm, Hh^Fdf, Hh, Hh^Fdf, Hh^Fdf, Gll^Fdf, Gll^Fdf, Gll^Fdf, Gll^Fdf, Gll^Fdf, Gs, Gll^Fdf, Gs, Gll^Fdf, Gll^Fdf, Gll^Fdf, Gs, Cv, Gs, Gll^Fdf, Gll^Fdf, Gs, Gs, Ww, Ww, Ww, Ww, Gll^Fdf, Gll^Fdf, Gs, Gs, Gll^Fdf, Gll^Fdf, Gll^Fdf, Gll^Fdf, Gll^Fdf, Gll^Fdf, Gll^Fdf, Gll^Fdf, Gll^Fdf
Gll^Fdf, Gll^Fdf, Hh, Hh, Mm, Mm, Mm, Mm, Hh^Fdf, Hh^Fdf, Hh^Fdf, Gll^Fdf, Gll^Fdf, Gs, Gll^Fdf, Gll^Fdf, Gll^Fdf, Gs, Gll^Fdf, Gll^Fdf, Hh, Gs, Gs, Gll^Fdf, Gs, Gll^Fdf, Gll^Fdf, Gs, Gs, Gll^Fdf, Ww, Ww, Ww, Ww, Ww, Gll^Fdf, Gll^Fdf, Gs, Gs, Gll^Fdf, Gll^Fdf, Gll^Fdf, Gll^Fdf, Gll^Fdf, Gll^Fdf, Gll^Fdf
Hh^Fdf, Hh, Hh^Fdf, Hh^Fdf, Mm, Mm, Mm, Hh, Hh^Fdf, Hh, Hh^Fdf, Gll^Fdf, Gll^Fdf, Gs, Gll^Fdf, Gll^Fdf, Gll^Fdf, Gll^Fdf, Hh, Gll^Fdf, Hh, Gll^Fdf, Hh, Gll^Fdf, Gll^Fdf, Gs, Gll^Fdf, Gll^Fdf, Gs, Gll^Fdf, Gll^Fdf, Ww, Ww, Ww, Ww, Gll^Fdf, Gll^Fdf, Gll^Fdf, Gll^Fdf, Gs, Gs, Gll^Fdf, Gll^Fdf, Gll^Fdf, Gll^Fdf, Gll^Fdf
Hh^Fdf, Hh^Fdf, Mm, Mm, Mm, Mm, Mm, Hh^Fdf, Hh^Fdf, Hh^Fdf, Hh^Fdf, Gll^Fdf, Hh^Fdf, Gs, Gll^Fdf, Hh, Hh, Gll^Fdf, Hh, Hh, Mm, Hh, Hh, Gg^Ve, Hh^Fdf, Gll^Fdf, Gll^Fdf, Gs, Gs, Gs, Gs, Gll^Fdf, Gs, Ww, Hh^Fdf, Ww, Ww, Gll^Fdf, Gll^Fdf, Gll^Fdf, Gll^Fdf, Gll^Fdf, Gll^Fdf, Gll^Fdf, Gs, Gll^Fdf
Hh^Fdf, Hh^Fdf, Mm, Mm, Mm, Mm, Hh^Fdf, Hh^Fdf, Hh^Fdf, Hh, Hh^Fdf, Gll^Fdf, Gll^Fdf, Hh, Gll^Fdf, Gll^Fdf, Gll^Fdf, Hh, Hh, Mm, Mm, Hh, Hh^Fdf, Hh^Fdf, Hh, Gll^Fdf, Gll^Fdf, Gll^Fdf, Gs, Gll^Fdf, Gll^Fdf, Gs, Gs, Ww, Hh^Fdf, Hh^Fdf, Hh^Fdf, Ww, Gll^Fdf, Gll^Fdf, Gll^Fdf, Gll^Fdf, Gll^Fdf, Gll^Fdf, Gs, Gll^Fdf
Gll^Fdf, Hh^Fdf, Hh^Fdf, Mm, Hh, Hh, Hh, Hh, Gs, Hh^Fdf, Gll^Fdf, Gll^Fdf, Gll^Fdf, Hh^Fdf, Hh^Fdf, Gll^Fdf, Gs, Hh^Fdf, Hh^Fdf, Mm, Mm, Mm, Mm, Hh^Fdf, Hh^Fdf, Hh^Fdf, Gll^Fdf, Gll^Fdf, Gll^Fdf, Gll^Fdf, Gs, Gs, Gs, Ww, Ww, Hh^Fdf, Hh^Fdf, Ww, Ww, Gll^Fdf, Gll^Fdf, Gll^Fdf, Gll^Fdf, Gll^Fdf, Gll^Fdf, Gll^Fdf
Hh^Fdf, Hh^Fdf, Hh, Hh, Hh, Hh, Hh^Fdf, Gs, Gll^Fdf, Gll^Fdf, Gll^Fdf, Hh^Fdf, Hh^Fdf, Hh, Hh, Gll^Fdf, Gll^Fdf, Hh, Hh^Fdf, Mm, Mm, Mm, Mm, Hh^Fdf, Hh^Fdf, Hh, Hh^Fdf, Gll^Fdf, Gll^Fdf, Gll^Fdf, Gll^Fdf, Gs, Gll^Fdf, Gll^Fdf, Gll^Fdf, Ww, Gs, Hh^Fdf, Ww, Gs, Gs, Gll^Fdf, Gs, Gll^Fdf, Gll^Fdf, Gll^Fdf
Gll^Fdf, Hh, Gll^Fdf, Gll^Fdf, Gs, Gll^Fdf, Gll^Fdf, Re^Vct, Gll^Fdf, Gs, Hh, Hh^Fdf, Hh^Fdf, Gll^Fdf, Hh, Gll^Fdf, Hh^Fdf, Hh^Fdf, Hh^Fdf, Hh^Fdf, Mm, Mm, Mm, Hh^Fdf, Hh^Fdf, Hh, Hh^Fdf, Gll^Fdf, Gll^Fdf, Gs, Gs, Gll^Fdf, Gs, Gll^Fdf, Gll^Fdf, Ww, Ww, Gs, Ww, Ww, Gs, Gll^Fdf, Gll^Fdf, Gll^Fdf, Gll^Fdf, Gll^Fdf
Gll^Fdf, Hh, Gll^Fdf, Re^Vct, Gll^Fdf, Gll^Fdf, Ce, Ce, Ce, Gll^Fdf, Hh^Fdf, Re^Vct, Hh, Gll^Fdf, Hh^Fdf, Hh^Fdf, Hh^Fdf, Hh, Hh, Gll^Fdf, Mm, Mm, Mm, Mm, Hh^Fdf, Hh, Hh^Fdf, Hh^Fdf, Hh^Fdf, Gll^Fdf, Gll^Fdf, Gs, Gll^Fdf, Gs, Gs, Gll^Fdf, Gll^Fdf, Ww, Ww, Ww, Gll^Fdf, Gs, Gll^Fdf, Gll^Fdf, Gll^Fdf, Gll^Fdf
Gll^Fdf, Hh, Hh, Gll^Fdf, Gll^Fdf, Ce, Ce, Ke, Ce, Ce, Gll^Fdf, Hh^Fdf, Hh^Fdf, Hh, Hh, Hh^Fdf, Hh^Fdf, Hh^Fdf, Gll^Fdf, Mm, Mm, Mm, Mm, Mm, Mm, Hh, Hh, Hh^Fdf, Hh, Gll^Fdf, Gll^Fdf, Gs, Gs, Gll^Fdf, Gs, Gll^Fdf, Gll^Fdf, Ww, Ww, Ww, Ww, Gll^Fdf, Gll^Fdf, Gll^Fdf, Gll^Fdf, Gll^Fdf
Gll^Fdf, Hh^Fdf, Hh, Hh, Gll^Fdf, Gll^Fdf, Gll^Fdf, Ce, Gll^Fdf, Gll^Fdf, Hh, Hh, Hh, Hh^Fdf, Hh^Fdf, Hh^Fdf, Hh^Fdf, Gll^Fdf, Mm, Mm, Mm, Mm, Mm, Mm, Hh, Hh^Fdf, Hh, Hh, Hh, Hh, Hh, Gll^Fdf, Gs, Gll^Fdf, Gll^Fdf, Gs, Gll^Fdf, Gll^Fdf, Gll^Fdf, Ww, Ww, Gll^Fdf, Gll^Fdf, Gll^Fdf, Gll^Fdf, Gll^Fdf
Gll^Fdf, Hh^Fdf, Hh^Fdf, Hh, Gs, Re^Vct, Hh^Fdf, Gll^Fdf, Hh^Fdf, Hh, Hh, Re^Vct, Hh^Fdf, Gll^Fdf, Hh^Fdf, Hh^Fdf, Mm, Mm, Mm, Mm, Mm, Mm, Mm, Mm, Hh, Hh, Hh^Fdf, Hh, Hh, Hh, Hh, Hh, Hh, Gll^Fdf, Gll^Fdf, Gs, Gll^Fdf, Gll^Fdf, Gll^Fdf, Ww, Ww, Gll^Fdf, Gs, Gs, Gll^Fdf, Gll^Fdf
Gll^Fdf, Gll^Fdf, Hh^Fdf, Hh^Fdf, Hh^Fdf, Hh^Fdf, Hh^Fdf, Hh^Fdf, Hh^Fdf, Gll^Fdf, Gs, Gll^Fdf, Gs, Gll^Fdf, Hh^Fdf, Hh^Fdf, Mm, Mm, Mm, Mm, Hh^Fdf, Hh^Fdf, Gll^Fdf, Mm, Mm, Hh, Mm, Hh, Hh, Hh, Hh, Hh, Hh, Hh, Hh, Gll^Fdf, Gll^Fdf, Gll^Fdf, Gll^Fdf, Gll^Fdf, Gll^Fdf, Ww, Gs, Gll^Fdf, Gll^Fdf, Gll^Fdf
Gll^Fdf, Gll^Fdf, Gll^Fdf, Gll^Fdf, Gll^Fdf, Hh^Fdf, Gll^Fdf, Gll^Fdf, Gll^Fdf, Gll^Fdf, Gll^Fdf, Hh^Fdf, Gll^Fdf, Gll^Fdf, Gll^Fdf, Gll^Fdf, Gll^Fdf, Mm, Gll^Fdf, Hh^Fdf, Gll^Fdf, Gll^Fdf, Gll^Fdf, Mm, Mm, Mm, Mm, Mm, Mm, Hh, Gll^Fdf, Hh^Fdf, Gll^Fdf, Hh, Gll^Fdf, Gll^Fdf, Gll^Fdf, Gll^Fdf, Gll^Fdf, Gll^Fdf, Gll^Fdf, Ww, Ww, Gll^Fdf, Gll^Fdf, Gll^Fdf
