border_size=1
usage=map

Ms, Ms, Ms, Ms, Ms, Ms, Ms, Ms, Ms, Ms, Ms, Mm, Mm, Mm, Mm, Gll^Fmf, Gll^Fmf, Gll^Fmf, Gd, Gll^Fmf, Hh, Gll^Fmf, Hh, Hh, Mm, Mm, Ms, Ms, Ms, Ms, Mm, Gll^Fmf, Hh, Gll^Fmf, Gll^Fmf
Ms, Ms, Ms, Ms, Ms, Ms, Ms, Ms, Ms, Ms, Ms, Ms, Mm, Mm, Mm, Gll^Fmf, Hh, Hh, Gd, Hh, Hh, Hh, Mm, Mm, Ms, Mm, Mm, Ms, Mm, Mm, Hh, Hh, Hh, Gll^Fmf, Gll^Fmf
Ms, Ms, Ms, Ms, Ms, Ms, Ms, Ms, Ms, Ms, Ms, Ms, Mm, Mm, Mm, Hh, Hh, Hh, Hh, Hh, Hh, Mm, Mm, Ms, Mm, Mm, Mm^Fmf, Mm, Hh, Hh, Re^Vct, Hh, Gd, Gd, Gll^Fmf
Ms, Ms, Ms, Ms, Ms, Ms, Ms, Ms, Ms, Ms, Ms, Ms, Mm, Mm, Hh^Fmf, Hh, Hh^Fmf, Hh^Fmf, Gll^Fmf, Gll^Fmf, Gll^Fmf, Hh, Hh, Mm, Hh^Fmf, Hh^Fmf, Hh, Hh, Hh, Hh, Gd, Gd, Hh, Hh, Hh^Fmf
Ms, Ms, Ms, Ms, Ms, Ms, Ms, Ms, Ms, Ms, Mm, Mm, Hh, Gll^Fmf, Hh^Fmf, Hh^Fmf, Hh, Gll^Fmf, Gd, Gll^Fmf, Gll^Fmf, Hh, Gll^Fmf, Hh, Gll^Fmf, Hh^Fmf, Gd, Hh, Gd, Gll^Fmf, Hh, Hh, Hh, Gll^Fmf, Hh
Ms, Ms, Ms, Ms, Ms, Ms, Mm, Mm, Mm, Mm, Hh, Hh, Hh^Fmf, Gd, Hh, Hh, Gll^Fmf, Gll^Fmf, Gd, Gll^Fmf, Hh, Gll^Fmf, Hh, Hh, Gll^Fmf, Gd, Gll^Fmf, Gd, Hh, Hh, Hh^Fmf, Hh, Ms, Hh, Mm
Ms, Ms, Ms, Ms, Mm, Mm, Hh, Mm, Gd, Hh^Fmf, Hh^Fmf, Hh^Fmf, Hh, Hh^Fmf, Gll^Fmf, Gll^Fmf, Gll^Fmf, Gll^Fmf, Hh, Hh, Hh, Hh^Fmf, Gll^Fmf, Hh, Gll^Fmf, Hh, Hh, Hh^Fmf, Hh^Fmf, Hh^Fmf, Hh, Mm, Ms, Ms, Mm
Mm, Ms, Mm, Mm, Mm, Hh, Hh, Hh^Fmf, Gd, Hh, Gll^Fmf, Hh, Gll^Fmf, Gll^Fmf, Gll^Fmf, Gll^Fmf, Gll^Fmf, Gll^Fmf, Gll^Fmf, Gll^Fmf, Gll^Fmf, Gll^Fmf, Gll^Fmf, Gd, Gd, Gll^Fmf, Hh^Fmf, Hh, Hh^Fmf, Hh^Fmf, Mm, Ms, Ms, Mm, Mm
Mm, Mm, Hh, Hh, Hh^Fmf, Hh^Fmf, Hh^Fmf, Gd, Gll^Fmf, Gll^Fmf, Gll^Fmf, Gll^Fmf, Hh, Hh, Gll^Fmf, Gd, Gll^Fmf, Gll^Fmf, Gll^Fmf, Gd, Hh, Hh, Hh, Gll^Fmf, Hh^Fmf, Hh^Fmf, Hh^Fmf, Hh^Fmf, Mm, Mm, Ms, Ms, Ms, Mm, Gll^Fmf
Hh, Hh, Hh^Fmf, Hh^Fmf, Gll^Fmf, Gll^Fmf, Gd, Gd, Gll^Fmf, Gll^Fmf, Gd, Gll^Fmf, Hh, Hh, Hh, Gll^Fmf, Gll^Fmf, Gll^Fmf, Gd, Gll^Fmf, Hh^Fmf, Hh^Fmf, Hh^Fmf, Hh, Hh^Fmf, Hh^Fmf, Hh, Mm, Mm, Mm, Ms, Ms, Ms, Mm, Gll^Fmf
Hh^Fmf, Hh, Hh, Hh, Gll^Fmf, Gll^Fmf, Gll^Fmf, Gll^Fmf, Gll^Fmf, Gd, Hh, Hh, Hh, Hh, Gll^Fmf, Gll^Fmf, Gll^Fmf, Hh, Gd, Gd, Hh, Hh, Hh, Hh, Hh, Hh^Fmf, Mm, Mm, Ms, Ms, Ms, Ms, Mm, Ms, Mm
Gll^Fmf, Gll^Fmf, Gll^Fmf, Gll^Fmf, Gd, Gd, Hh^Fmf, Gll^Fmf, Gd, Gll^Fmf, Hh^Fmf, Gll^Fmf, Gll^Fmf, Gll^Fmf, Gd, Gll^Fmf, Hh, Hh, Hh^Fmf, Hh, Mm, Mm, Mm, Mm, Mm, Mm, Ms, Ms, Ms, Ms, Ms, Mm, Ms, Ms, Gll^Fmf
Gll^Fmf, Gll^Fmf, Gd, Gd, Gll^Fmf, Hh, Gll^Fmf, Hh, Gll^Fmf, Gd, Gll^Fmf, Gll^Fmf, Gll^Fmf, Gd, Gll^Fmf, Gd, Hh^Fmf, Hh^Fmf, Mm, Mm, Mm, Mm, Ms, Mm, Ms, Ms, Ms, Ms, Ms, Ms, Mm, Ms, Mm, Mm, Gll^Fmf
Gll^Fmf, Gll^Fmf, Gll^Fmf, Gll^Fmf, Gll^Fmf, Gll^Fmf, Gll^Fmf, Gll^Fmf, Gll^Fmf, Gll^Fmf, Gll^Fmf, Gd, Gll^Fmf, Gll^Fmf, Gll^Fmf, Hh, Gll^Fmf, Hh, Mm, Mm, Mm, Ms, Mm, Ms, Mm, Ms, Mm, Ms, Mm, Mm, Mm, Ms, Gll^Fmf, Gll^Fmf, Gll^Fmf
